22222222222222-
02201222222220-
00001220022000-
03001000010000-
00001000010000-
00111003011100-
00100000000100-
00110300001100-
00010000001000-
00010000001000-
00011111111000-
00000100100000-
11111100100300-
10000000100000-
11111000111111-
00001000000001-
00111055000011-
00100000000110-
30111111111100-
00000010000000-
00000060000000-
00000000000000