22222222222222-
22222222222222-
00010030001000-
00010000001000-
00011101111000-
00000101000000-
00030101000000-
00000101000300-
01111101000000-
01000001000000-
01000001000000-
01110001111100-
00010005000100-
00110005000100-
00100000111100-
00100000100000-
00100001100000-
00100001000000-
00111111000300-
00000100000000-
00000600000000-
00000000000000