0221222-
0001022-
0111030-
0100000-
0111100-
0000100-
4011100-
4010000-
0010000-
0010000-
0000000