22222222222222-
22222222222222-
10000010000010-
13111010111310-
13101010101310-
11101010101110-
00001010100000-
00001010100000-
00111111111000-
00131010131000-
00131010131000-
00111010111000-
00001010100000-
00001010100000-
03031313130300-
00001111100000-
00303010303000-
00000010000000-
00011111110000-
00313010313000-
00011161110000-
03030303030300