2221222-
0001222-
0111000-
0100003-
0111100-
0000100-
0011100-
0310055-
5010000-
5060000-
0000000