0221222-
0001022-
0111030-
0100005-
0111100-
0500100-
4011100-
4010000-
0010000-
0010000-
0000000