2222222-
0100000-
0100040-
0100040-
0100000-
0111110-
5000010-
0030015-
0000010-
0300010-
0050060